🟫🟫🟫🟫🟫🟫🟫🟫🟫🟫🟫🟫🟫🟫🟫🟫🟫🟫🟫🟫🟫🟫🟫🟫🟫🟫🟫🟫🟫🟫🟫🟫🟫🟫🟫🟫🟫🟫🟫🟫🟫
🟫🟨🟨🟨🟫🟨🟨🟨🟫🟨🟨🟨🟨🟨🟨🟨🟨🟨🟨🟨🟫🟨🟨🟨🟨🟨🟨🟨🟨🟨🟨🟨🟫🟨🟨🟨🟨🟨🟨🟨🟫
🟫🟨🟫🟨🟫🟨🟫🟨🟫🟫🟫🟨🟫🟫🟫🟫🟫🟨🟫🟨🟫🟫🟫🟨🟫🟫🟫🟫🟫🟫🟫🟨🟫🟫🟫🟫🟫🟫🟫🟨🟫
🟫🟨🟫🟨🟨🟨🟫🟨🟨🟨🟫🟨🟫🟨🟨🟨🟫🟨🟫🟨🟨🟨🟫🟨🟫🟨🟨🟨🟨🟨🟫🟨🟨🟨🟨🟨🟫🟨🟨🟨🟫
🟫🟨🟫🟫🟫🟫🟫🟫🟫🟨🟫🟫🟫🟨🟫🟨🟫🟨🟫🟫🟫🟨🟫🟨🟫🟫🟫🟨🟫🟨🟫🟫🟫🟫🟫🟨🟫🟨🟫🟫🟫
🟫🟨🟨🟨🟨🟨🟫🟨🟫🟨🟫🟨🟨🟨🟫🟨🟨🟨🟫🟨🟨🟨🟫🟨🟨🟨🟫🟨🟫🟨🟨🟨🟨🟨🟨🟨🟫🟨🟨🟨🟫
🟫🟨🟫🟫🟫🟨🟫🟨🟫🟨🟫🟨🟫🟫🟫🟫🟫🟫🟫🟨🟫🟫🟫🟨🟫🟨🟫🟨🟫🟫🟫🟫🟫🟫🟫🟫🟫🟫🟫🟨🟫
🟫🟦🟫🟨🟨🟨🟫🟨🟫🟨🟫🟨🟨🟨🟨🟨🟫🟨🟫🟨🟫🟨🟨🟨🟫🟨🟫🟨🟫🟨🟨🟨🟨🟨🟨🟨🟨🟨🟫🟨🟫
🟫🟫🟫🟨🟫🟫🟫🟨🟫🟨🟫🟨🟫🟫🟫🟨🟫🟨🟫🟨🟫🟫🟫🟫🟫🟨🟫🟨🟫🟨🟫🟫🟫🟫🟫🟫🟫🟨🟫🟨🟫
🟫🟨🟨🟨🟫🟨🟨🟨🟨🟨🟫🟨🟫🟨🟨🟨🟫🟨🟫🟨🟨🟨🟨🟨🟨🟨🟫🟨🟫🟨🟫🟨🟨🟨🟫🟨🟫🟨🟨🟨🟫
🟫🟨🟫🟫🟫🟨🟫🟫🟫🟫🟫🟫🟫🟨🟫🟫🟫🟨🟫🟫🟫🟫🟫🟫🟫🟫🟫🟨🟫🟨🟫🟨🟫🟨🟫🟨🟫🟫🟫🟨🟫
🟫🟨🟫🟨🟨🟨🟨🟨🟨🟨🟫🟨🟨🟨🟫🟨🟨🟨🟫🟨🟨🟨🟫🟨🟨🟨🟨🟨🟫🟨🟨🟨🟫🟨🟫🟨🟨🟨🟫🟨🟫
🟫🟨🟫🟨🟫🟫🟫🟫🟫🟨🟫🟨🟫🟫🟫🟨🟫🟨🟫🟨🟫🟨🟫🟨🟫🟫🟫🟫🟫🟫🟫🟨🟫🟨🟫🟫🟫🟨🟫🟨🟫
🟫🟨🟫🟨🟫🟨🟨🟨🟫🟨🟨🟨🟫🟨🟨🟨🟫🟨🟫🟨🟫🟨🟨🟨🟨🟨🟨🟨🟨🟨🟫🟨🟫🟨🟫🟨🟨🟨🟫🟨🟫
🟫🟨🟫🟫🟫🟨🟫🟨🟫🟨🟫🟫🟫🟫🟫🟫🟫🟨🟫🟨🟫🟫🟫🟫🟫🟫🟫🟫🟫🟨🟫🟫🟫🟨🟫🟨🟫🟫🟫🟨🟫
🟫🟨🟫🟨🟨🟨🟫🟨🟫🟨🟫🟨🟨🟨🟨🟨🟫🟨🟨🟨🟨🟨🟫🟨🟨🟨🟫🟨🟫🟨🟨🟨🟫🟨🟫🟨🟨🟨🟫🟨🟫
🟫🟨🟫🟨🟫🟫🟫🟨🟫🟨🟫🟨🟫🟫🟫🟨🟫🟫🟫🟫🟫🟫🟫🟨🟫🟨🟫🟨🟫🟫🟫🟨🟫🟨🟫🟫🟫🟨🟫🟨🟫
🟫🟨🟨🟨🟫🟨🟫🟨🟫🟨🟫🟨🟫🟨🟫🟨🟨🟨🟨🟨🟨🟨🟨🟨🟫🟨🟫🟨🟨🟨🟨🟨🟨🟨🟫🟨🟨🟨🟫🟨🟫
🟫🟨🟫🟫🟫🟨🟫🟨🟫🟫🟫🟨🟫🟨🟫🟫🟫🟫🟫🟫🟫🟫🟫🟫🟫🟨🟫🟫🟫🟫🟫🟫🟫🟫🟫🟨🟫🟫🟫🟨🟫
🟫🟨🟫🟨🟨🟨🟫🟨🟫🟨🟨🟨🟨🟨🟫🟨🟨🟨🟫🟨🟨🟨🟨🟨🟨🟨🟫🟨🟨🟨🟨🟨🟨🟨🟫🟨🟨🟨🟫🟨🟫
🟫🟨🟫🟫🟫🟨🟫🟨🟫🟨🟫🟫🟫🟫🟫🟨🟫🟨🟫🟨🟫🟫🟫🟫🟫🟫🟫🟨🟫🟫🟫🟫🟫🟨🟫🟨🟫🟨🟫🟨🟫
🟫🟨🟨🟨🟨🟨🟫🟨🟫🟨🟨🟨🟫🟨🟨🟨🟫🟨🟫🟨🟫🤖🟫🟨🟨🟨🟨🟨🟫🟨🟫🟨🟨🟨🟫🟨🟫🟨🟨🟨🟫
🟫🟫🟫🟫🟫🟫🟫🟨🟫🟫🟫🟨🟫🟨🟫🟫🟫🟨🟫🟨🟫🟨🟫🟨🟫🟫🟫🟫🟫🟨🟫🟨🟫🟫🟫🟨🟫🟫🟫🟫🟫
🟫🟨🟨🟨🟨🟨🟫🟨🟨🟨🟨🟨🟫🟨🟨🟨🟫🟨🟨🟨🟫🟨🟨🟨🟫🟨🟨🟨🟫🟨🟨🟨🟫🟨🟨🟨🟫🟨🟨🟨🟫
🟫🟨🟫🟫🟫🟨🟫🟫🟫🟫🟫🟨🟫🟫🟫🟨🟫🟫🟫🟨🟫🟫🟫🟫🟫🟨🟫🟨🟫🟨🟫🟫🟫🟨🟫🟫🟫🟫🟫🟨🟫
🟫🟨🟫🟨🟨🟨🟫🟨🟨🟨🟫🟨🟨🟨🟫🟨🟫🟨🟨🟨🟫🟨🟨🟨🟫🟨🟫🟨🟨🟨🟫🟨🟫🟨🟨🟨🟨🟨🟨🟨🟫
🟫🟨🟫🟨🟫🟫🟫🟨🟫🟨🟫🟫🟫🟫🟫🟨🟫🟨🟫🟫🟫🟨🟫🟨🟫🟨🟫🟫🟫🟫🟫🟨🟫🟫🟫🟫🟫🟫🟫🟨🟫
🟫🟨🟫🟨🟨🟨🟨🟨🟫🟨🟨🟨🟫🟨🟨🟨🟫🟨🟨🟨🟫🟨🟫🟨🟨🟨🟫🟨🟫🟨🟨🟨🟨🟨🟨🟨🟨🟨🟫🟨🟫
🟫🟨🟫🟫🟫🟫🟫🟫🟫🟫🟫🟨🟫🟨🟫🟫🟫🟫🟫🟨🟫🟨🟫🟫🟫🟫🟫🟨🟫🟨🟫🟫🟫🟫🟫🟫🟫🟨🟫🟨🟫
🟫🟨🟨🟨🟨🟨🟨🟨🟨🟨🟫🟨🟨🟨🟫🟨🟨🟨🟫🟨🟫🟨🟨🟨🟫🟨🟨🟨🟨🟨🟫🟨🟨🟨🟨🟨🟫🟨🟫🟨🟫
🟫🟫🟫🟫🟫🟫🟫🟫🟫🟨🟫🟫🟫🟫🟫🟨🟫🟨🟫🟫🟫🟫🟫🟨🟫🟨🟫🟫🟫🟫🟫🟨🟫🟫🟫🟨🟫🟨🟫🟨🟫
🟫🟨🟫🟨🟨🟨🟨🟨🟫🟨🟫🟨🟨🟨🟨🟨🟫🟨🟨🟨🟨🟨🟨🟨🟫🟨🟫🟨🟨🟨🟨🟨🟫🟨🟨🟨🟫🟨🟫🟨🟫
🟫🟨🟫🟨🟫🟫🟫🟨🟫🟨🟫🟨🟫🟫🟫🟫🟫🟫🟫🟫🟫🟫🟫🟫🟫🟫🟫🟨🟫🟫🟫🟫🟫🟨🟫🟫🟫🟨🟫🟨🟫
🟫🟨🟫🟨🟨🟨🟫🟨🟨🟨🟫🟨🟫🟨🟨🟨🟫🟨🟨🟨🟨🟨🟫🟨🟨🟨🟨🟨🟫🟨🟨🟨🟫🟨🟨🟨🟫🟨🟫🟨🟫
🟫🟨🟫🟫🟫🟨🟫🟫🟫🟫🟫🟨🟫🟨🟫🟨🟫🟨🟫🟨🟫🟨🟫🟫🟫🟨🟫🟫🟫🟨🟫🟨🟫🟫🟫🟨🟫🟨🟫🟨🟫
🟫🟨🟨🟨🟫🟨🟨🟨🟨🟨🟨🟨🟫🟨🟫🟨🟨🟨🟫🟨🟫🟨🟫🟨🟨🟨🟫🟨🟨🟨🟫🟨🟨🟨🟫🟨🟨🟨🟫🟨🟫
🟫🟨🟫🟨🟫🟫🟫🟫🟫🟫🟫🟫🟫🟨🟫🟫🟫🟫🟫🟨🟫🟨🟫🟨🟫🟫🟫🟨🟫🟫🟫🟫🟫🟨🟫🟫🟫🟫🟫🟨🟫
🟫🟨🟫🟨🟫🟨🟨🟨🟨🟨🟨🟨🟫🟨🟫🟨🟨🟨🟫🟨🟫🟨🟨🟨🟫🟨🟨🟨🟫🟨🟨🟨🟫🟨🟨🟨🟨🟨🟫🟨🟫
🟫🟨🟫🟨🟫🟨🟫🟫🟫🟨🟫🟫🟫🟨🟫🟨🟫🟨🟫🟨🟫🟫🟫🟫🟫🟨🟫🟫🟫🟫🟫🟨🟫🟫🟫🟫🟫🟨🟫🟨🟫
🟫🟨🟫🟨🟨🟨🟨🟨🟫🟨🟨🟨🟨🟨🟨🟨🟫🟨🟫🟨🟨🟨🟨🟨🟨🟨🟨🟨🟨🟨🟨🟨🟨🟨🟨🟨🟫🟨🟨🟨🟫
🟫🟫🟫🟫🟫🟫🟫🟫🟫🟫🟫🟫🟫🟫🟫🟫🟫🟫🟫🟫🟫🟫🟫🟫🟫🟫🟫🟫🟫🟫🟫🟫🟫🟫🟫🟫🟫🟫🟫🟫🟫